NO ./mandatory/assets/mossystone.xpm
SO ./mandatory/assets/pikuma.xpm
EA ./mandatory/assets/purplestone.xpm
WE ./fuck.xpm

F 64,64,64
C 32,33,32

1111111111111111111111111111111111111111111
10000000000000000000000000000000000W0000001
1000100010100001010000000001000000000100001
1010000000000000000000000000000010000000001
1000000001000000100010001000000000000000001
1000100000000100000000000000100000000000001
1000010000000000000010000000000000000000001
1000000001000000000000001000000000000000001
1000010000000000000010000000000100000000001
1000000001000000010000010000000000000010001
1000010000001000000000000000000000000000001
1001000100100001010000100100100000001000001
1000000000000000000000000000000000000000001
1111111111111111111111111111111111111111111